He does n't have the ability to do the work properly .	Han er ikke i stand til å gjøre arbeidet skikkelig .
Do you know what this box is made of ?	Vet du hva denne boksen er laget av ?
I found my first gray hair this morning .	Jeg fant mitt første gråe hår i morges .
You should n't eat just before you go to bed .	Du bør ikke spise rett før du legger deg .
I got to know him when I was a student .	Jeg ble kjent med ham da jeg var student .
Tom has as many books as I have .	Tom har like mange bøker som meg .
Those who live in glass houses should not throw stones .	Man skal ikke kaste stein i glasshus .
I think I 'll lie down for a while .	Jeg tror jeg skal legge meg litt .
Tom only knows how to speak a little French .	Tom kan bare snakke litt fransk .
Tom and I have played poker together many times .	Tom og jeg har spilt poker sammen mange ganger .
Tom said it would be OK if I did n't attend this afternoon 's meeting .	Tom sa at det er greit at jeg ikke deltar på møtet i kveld .
There are a lot of places to see around here .	Det er mange steder å se her i området .
When you expect to get something for nothing , the only person you 're fooling is yourself .	Når du forventer å få noe for intet , lurer du kun deg selv .
I do n't want to do it because it 's dangerous and it 's stupid .	Jeg har ikke lyst til å gjøre det fordi det er farlig og idiotisk .
Last night someone broke into the small shop near my house .	I går natt brøt noen seg inn i den lille butikken nær huset mitt .
Tom had to explain the joke to Mary .	Tom måtte forklare vitsen til Mary .
We 've had a lot of rain this month .	Vi har hatt mye regn denne måneden .
It seems that Tom and Mary both like classical music .	Det ser ut som både Tom og Mary liker klassisk musikk .
Tom 's operation was going to cost a small fortune .	Toms operasjon ville kostet en halv formue .
Mary is n't really sick. She 's only pretending to be .	Maria er ikke virkelig syk , hun bare later som .
