He does n't have the ability to do the work properly .	Han er ikke i stand til å gjøre arbeidet skikkelig .
Do you know what this box is made of ?	Vet du hva denne boksen er laget av ?
I found my first gray hair this morning .	Jeg fant mitt første gråe hår i morges .
You should n't eat just before you go to bed .	Du bør ikke spise rett før du legger deg .
I got to know him when I was a student .	Jeg ble kjent med ham da jeg var student .
Tom has as many books as I have .	Tom har like mange bøker som meg .
Those who live in glass houses should not throw stones .	Man skal ikke kaste stein i glasshus .
I think I 'll lie down for a while .	Jeg tror jeg skal legge meg litt .
Tom only knows how to speak a little French .	Tom kan bare snakke litt fransk .
Tom and I have played poker together many times .	Tom og jeg har spilt poker sammen mange ganger .
Tom said it would be OK if I did n't attend this afternoon 's meeting .	Tom sa at det er greit at jeg ikke deltar på møtet i kveld .
There are a lot of places to see around here .	Det er mange steder å se her i området .
When you expect to get something for nothing , the only person you 're fooling is yourself .	Når du forventer å få noe for intet , lurer du kun deg selv .
I do n't want to do it because it 's dangerous and it 's stupid .	Jeg har ikke lyst til å gjøre det fordi det er farlig og idiotisk .
Last night someone broke into the small shop near my house .	I går natt brøt noen seg inn i den lille butikken nær huset mitt .
Tom had to explain the joke to Mary .	Tom måtte forklare vitsen til Mary .
We 've had a lot of rain this month .	Vi har hatt mye regn denne måneden .
It seems that Tom and Mary both like classical music .	Det ser ut som både Tom og Mary liker klassisk musikk .
Tom 's operation was going to cost a small fortune .	Toms operasjon ville kostet en halv formue .
Mary is n't really sick. She 's only pretending to be .	Maria er ikke virkelig syk , hun bare later som .
It 's easy to lose your footing on loose gravel .	Det er lett å miste fotfeste på løs grus .
Because of heavy snow , the plane from Beijing arrived 20 minutes late .	På grunn av tung snø , ankom flyet fra Beijing 20 minutter for sent .
I do n't need Tom to do that again .	Jeg trenger ikke at Tom gjør det igjen .
I assume you must be a close friend of Tom 's .	Jeg antar du må være en nær venn av Tom .
Excuse me , can you tell me how to get to Central Park ?	Unnskyld , kan du forklare meg hvordan en kommer seg til Central Park ?
The exhibition will be open for another month .	Utstillingen vil være åpen i en måned til .
Give me a ring if you find out anything .	Ring meg hvis du finner ut noe .
You 're never going to find a better boyfriend than Tom .	Du kommer aldri til å finne en bedre kjæreste enn Tom .
It is questionable whether this data can be relied on .	Det er tvilsomt om en kan stole på disse dataene .
He is always complaining about his low salary .	Han klager bestandig om sin lave lønn .
I used to play here as a child .	Jeg pleide å leke her som liten .
You do n't think Tom really could 've done that , do you ?	Du tror ikke at tom virkelig kunne ha gjort det , gjør du ?
I go to school because I want to learn .	Jeg går på skole fordi jeg ønsker å lœre .
They were sitting on the sofa in our living room .	De satt i sofaen i stua vår .
Tom thought his violin was a Stradivarius because the name Stradivarius was on the label inside his violin .	Tom trodde fiolinen sin var en Stradivarius fordi navnet Stradivarius stod skrevet på etiketten inni fiolinen .
He failed because he did not have money .	Han mislykte fordi han ikke hadde penger .
I have a cold and a 38 - degree fever .	Jeg er forkjølet og har 38 graders feber .
I wish I could figure out how to fix this .	Jeg skulle ønske jeg kunne finne ut hvordan man kan reparere dette .
The town is famous for its hot spring .	Denne byen er berømt for sin varme kilde .
There was a high wall about the garden .	Det var en høy vegg om hagen .
If you ever come to Boston , you 're welcome to stay with us .	Hvis du noen gang kommer til Boston , er du velkommen til overnatte hos oss .
All horses are animals , but not all animals are horses .	Alle hester er dyr , men ikke alle dyr er hester .
Grandmother looks after the children during the day .	Bestemor tar hånd om barna om dagen .
When I was a child , my mother would often read fairy tales to me .	Når jeg var liten , pleide moren min å fortelle meg eventyr .
Come what may , I will not break my word .	Uansett hva som skjer , kommer jeg ikke til å bryte løftet mitt .
Tom 's fingers got smashed while working on the assembly line .	Toms fingre ble knust mens han jobbet ved samlebåndet .
Nineteen states voted in the elections of 1816 .	Nitten stater stemte i valgene i 1816 .
I should n't have to do all this work by myself .	Jeg burde ikke måtte gjøre alt dette arbeidet alene .
I think it 's strange that no one is on the street this time of the day .	Jeg synes det er rart at ingen ute i gaten på denne tiden av døgnet .
When darkness falls , the baboons return to the trees to sleep , safe from night prowlers .	Når mørket faller , vender bavianene tilbake til trærne for å sove , trygg fra nattens jegere .
I 'll always love you , no matter what happens .	Jeg vil alltid elske deg , uansett hva som skjer .
The boy gathered a handful of peanuts and put them in a small box .	Gutten samlet en håndfull peanøtter og puttet dem i en liten boks .
I had a crowbar in one hand and a hammer in the other .	Jeg hadde et brekkjern i den ene hånden og en hammer i den andre .
This is the house in which he was born .	Dette er huset hvor han ble født .
Would you like me to switch on the light ?	Vil du at jeg skal skru på lyset ?
When did you see her dancing with him ?	Når så du henne danse med ham ?
It 's not enough to just say you 're going to vote. You need to vote .	Det er ikke nok å bare si at du kommer til å stemme. Du må stemme .
It is too dark for me to read .	Det er for mørkt til at jeg kan lese .
Tom said he thought that we should try to get there early .	Tom sa han mente at vi skulle prøve å dra dit tidlig .
I can n't keep up with you if you walk so fast .	Jeg greier ikke å holde følge med deg hvis du går så fort .
They have lived here for a long time .	De har bodd her i lang tid .
She got married at the age of seventeen .	Hun ble gift i en alder av søtten .
Tom did n't think that Mary knew how to swim .	Tom trodde ikke Maria kunne svømme .
We need to work together in order to make the world a better place .	Vi må samarbeide for å gjøre verden til et bedre sted .
There is a suspension bridge ahead of us .	Det er en hengebro på veien foran oss .
I opened the door and saw two boys standing side by side .	Jeg åpnet døren og så to gutter som sto side om side .
I 'd like to learn to play the piano , the guitar or the flute .	Jeg vil lære å spille piano , gitar , eller fløyte .
I want to know why Tom and Mary do n't get along .	Jeg vil vite hvorfor Tom og Mary ikke kommer overens .
Grandmother 's ashes are in an urn at the temple .	Bestemors aske er i en urne i tempelet .
I do n't have a CD player , but I bought the CD anyway .	Jeg har ingen CD - spiller , men jeg kjøpte CDen allikevel .
I wish I had studied harder for the test .	Jeg skulle ønske at jeg hadde øvd mer på prøven .
I will badly miss you if you leave Japan .	Jeg vil savne deg veldig hvis du forlater Japan .
Tom said he intends to go to Australia next October .	Tom sa at han planlegger å dra til Australia neste oktober .
His name is on the tip of my tongue .	Jeg har navnet hans på tungen .
If I had had enough money , I would have bought the book .	Hvis jeg hadde hatt nok penger ville jeg ha kjøpt boken .
Tom had only himself to blame for the failure .	Tom hadde kun seg selv å klandre for nederlaget .
He lives in a luxury apartment close to Central Park .	Han bor i en luksusleilighet i nærheten av Central Park .
Tom said Mary was likely to still be quicker at doing that than John .	Tom sa at Mary sannsynligvis fortsatt ville være raskere til å gjøre det enn John .
It 's very hard to play Vivaldi 's bassoon concertos on the saxophone .	Det er veldig vanskelig å spille Vivaldis fagottkonsert på saksofon .
What was it that you wanted me to tell Tom ?	Hva var det du ville at jeg skulle fortelle Tom ?
It was so hot I took my coat off .	Jeg var så varm at jeg tok av meg frakken .
I knew I was wasting my time trying to convince Tom .	Jeg visste at det var bortkastet tid å prøve å overbevise Tom .
You do n't really think Tom tried to cheat you , do you ?	Du tror ikke virkelig at Tom prøvde å jukse , gjør du ?
I returned to my native village after two years' absence .	Jeg dro tilbake til min hjemby etter å ha vært borte i to år .
I was very tired , so I went to bed early .	Jeg var veldig trøtt , så jeg la meg tidlig .
I prefer living in the country to living in the city .	Jeg foretrekker å bo på landet , framfor byen .
I 've waited all my life for this day .	Jeg har ventet på denne dagen hele livet mitt .
Tom did n't like school until he entered junior high school .	Tom likte ikke skolen , frem til han startet på ungdomsskolen .
We have more in common than I thought .	Vi har mer felles enn jeg trodde .
Tom should 've left when he had the chance .	Tom skulle ha dratt når han hadde sjangsen .
Tom wishes that he could be a better French speaker .	Tom skulle ønske han var bedre i fransk .
We were late as a result of the traffic jam .	Vi kom for sent på grunn av trafikkorken .
Tom would like to become a simultaneous interpreter .	Tom har lyst til å bli en tolk .
That does n't mean that the danger has passed .	Det betyr ikke at faren har passert .
Tom says he intends to play golf with us this afternoon .	Tom sier han tenker å spille golf med oss i dag ettermiddag .
Mother is more anxious about the result of the examination than I am .	Mor er mer nervøs for eksamensresultatet enn jeg er .
Tom and Mary can n't afford to buy a house .	Tom og Mary har ikke råd til å kjøpe hus .
A violinist I know claims that he owns a Stradivarius .	En fiolinist jeg kjenner hevder at han eier en Stradivarius .
There were three hundred cardboard boxes filled with old clothes ready to be sent to the disaster area .	Tre hundre pappesker fylt med gamle klær stod klare til å bli sendt til katastrofeområdet .
I know that I should sleep for at least eight hours per day. However , usually I sleep less .	Jeg vet at jeg burde sove minst åtte timer i døgnet , men jeg sover vanligvis mindre enn det .
I interviewed a lady who works to protect the environment .	Jeg intervjuet en kvinne som jobber for å beskytte miljøet .
The animal struggled to get out of the cage .	Dyret kjempet for å komme seg ut av buret .
You may go home if you want to .	Du kan gå hjem hvis du vil .
We 've got to finish this before we can go home .	Vi må gjøre dette ferdig før vi kan gå hjem .
The school rules require students to wear school uniforms .	Skolens regler krever at elevene skal være iført skoleuniform .
There are around three thousand mosques in Istanbul .	Det er circa tre tusen moskéer i Istanbul .
Passengers became nervous when the plane began to vibrate .	Passasjerene ble engstelige da flyet begynte å riste .
You do n't have to do that now , do you ?	Du må ikke gjøre det nå , må du ?
The police arrested the suspect in the case .	Politiet arresterte den mistenkte i saken .
It is surprising how many unhappy marriages there are .	Det er overraskende hvor mange ulykkelige ekteskap som finnes .
Tom told Mary that he did n't have to do anything .	Tom sa til Mary at han ikke måtte gjøre noe .
How many cups of coffee does Tom usually drink a day ?	Hvor mange kopper kaffe drikker Tom vanligvis per dag ?
I wear my old coat in weather like this .	Jeg pleier å ha på meg den gamle frakken min i slikt vær .
Tom said that he does n't know how to do that .	Tom sa at han ikke vet hvordan man gjør det .
When I arrived , they quickly cleared out of the house .	Når jeg kom , skyndet de seg ut av huset .
Once you 've formed a bad habit , you can n't get rid of it easily .	Når man først har fått en dårlig vane , er det ikke lett å bli kvitt den .
I met an old friend in the park .	Jeg møtte en gammel venn i parken .
The majority of my patients come to me from out of town .	Mesteparten av pasientene mine kommer fra utenfor byen .
All the eggs in the box were broken .	Alle eggene i boksen var knuste .
Common sense is the collection of prejudices acquired by age eighteen .	Sunn fornuft er samlingen av fordommer man har tilegnet seg innen en alder av atten år .
"Jump across the ditch." "I will if you will."	"Hopp over grøfta." "Jeg gjør det hvis du gjør det."
I just feel like I 'm not doing what you expect me to do .	Jeg føler at jeg ikke gjør det du forventer at jeg skal gjøre .
It is difficult to translate a poem into another language .	Det er vanskelig å oversette et dikt til et annet språk .
That way we kill two birds with one stone .	Slik slår vi to fluer i én smekk .
Please put your shoes in the shoebox when you take them off .	Putt skoene i skoboksen etter du har tatt dem av deg .
What do you do to pass the time ?	Hva gjør du for å få tiden til å gå ?
He always pays attention to his children 's behavior .	Han er alltid oppmerksom på sine barns oppførsel .
I do n't have enough time to explain that to you in detail .	Jeg har ikke tid til å forklare det til deg i detalj .
We 'll have a good crop if this good weather keeps up .	Vi vil få en god avling hvis det fine været fortsetter .
All students are free to use the university library .	Alle universitetets studenter kan fritt benytte universitetsbiblioteket .
I do n't want to live in a big mansion .	Jeg vil ikke bo i et stort herskapshus .
It will make little difference whether you go there by taxi or on foot .	Det gjør liten forskjell om du tar drosje eller går dit .
Tom agreed with me a hundred per cent .	Tom var hundre prosent enig med meg .
Do you know why Tom has to do that ?	Vet du hvorfor Tom er nødt å gjøre det ?
She has decided to live in the United States for good .	Hun har bestemt seg for å bo i USA for godt .
Until the teacher appeared , the children were running amok in the classroom .	Frem til læreren dukket opp , gikk barna amok i klasserommet .
Which is the more expensive of the two ?	Hvilken er dyrest av de to ?
Some of my friends can speak English well .	Noen av vennene mine snakker engelsk bra .
If you were me , what would you do ?	Hvis du var meg , hva ville du gjort ?
France has a higher birthrate than most of Europe .	Frankrike har høyere fødselsrate enn de fleste steder i Europa .
It was hot , so we swam in the pool .	Det var varmt , så vi svømte i bassenget .
The last time we went out to eat , she paid for the dinner .	Forrige gang vi spiste ute betalte hun for middagen .
You still want me to come , do n't you ?	Du vil fortsatt at jeg kommer , gjør du ikke .
Never go to a doctor whose office plants have died .	Gå aldri til en lege som har latt sine kontorplanter dø .
Some people say stepping on a worm makes it rain .	Enkelte sier at dersom du tråkker på en meitemark , så begynner det å regne .
The boy standing over there is my son .	Gutten som står der borte er min sønn .
Tom went to Boston to attend a conference .	Tom drog til Boston for å gå på en konferanse .
Tom told me he knew how to speak French .	Tom fortalte meg at han kunne snakke fransk .
It will not be long before the winter vacation ends .	Det tar ikke lang tid før vinterferien er over .
Tom was n't able to find a place to park .	Tom klarte ikke å finne et sted å parkere .
All you have to do is to hand this book to him .	Du trenger kun gi denne boken til han .
I wish I had n't spent so much money .	Jeg skulle ønske jeg ikke hadde brukt så mye penger .
Did Tom say he thought it would be hard to do that ?	Sa Tom at han trodde det ville være for vanskelig å gjøre det ?
Atomic energy can be utilized for peaceful purposes .	Atomenergi kan brukes til fredelige formål .
"Where do you live?" "I live in Tokyo."	«Hvor bor du?» «Jeg bor i Tokyo.»
He did n't get in until 2 o'clock in the morning .	Han kom ikke inn før klokka to om natta .
If it rains tomorrow , I 'll stay at home .	Hvis det regner i morgen , blir jeg hjemme .
The factory decided to do away with the old machinery .	Fabrikken bestemte seg for å kvitte seg med de gamle maskinene .
Tom has a hole in one of his socks .	Tom har et hull i en av sokkene sine .
All the citizens of the city have access to the city library .	Alle innbyggerne i byen kan anvende byens biblioteker .
The stock market crash forced many retirees back into the job market .	Børskrakket tvang mange pensjonister tilbake til arbeidsmarkedet .
Tom thinks that he 's the center of the universe .	Tror tror han er universets senter .
Don't treat me the same way you would treat a child .	Ikke behandle meg på samme måten som du ville behandlet et barn .
She writes to her son every now and then .	Hun skriver til sin sønn en gang i blant .
I was given a nasty look when I asked for my prescription at the local doctor 's .	Jeg ble slengt et stygt blikk da jeg spurte etter resepten min på det lokale legekontoret .
Let us know if you can make it .	La oss vite om du kan komme .
There are lots of things I want to talk about .	Det er mange ting jeg har lyst til å snakke om .
There is a car in front of the building .	Det er en bil foran bygningen .
He was robbed when coming home late at night .	Han ble ranet idet han kom hjem sent om natta .
My brother has been living in London for many years .	Broren min har bodd i London i mange år .
He 's made up his mind and refuses to change it .	Han har bestemt seg og nekter å endre mening .
My friend recommended that I should n't buy an iPad yet , but to wait until I see what Apple 's competitors come out with .	Vennen min anbefalte meg å ikke kjøpe en iPad ennå , men vente og se hva konkurrentene til Apple kommer med .
Tom decided not to tell his parents about what had happened .	Tom bestemte seg for å ikke fortelle foreldrene sine om det som hadde skjedd .
We have more important things that need to be dealt with .	Vi har viktigere ting som må gjøres .
They want to have a meeting with you .	De vil ha et møte med deg .
"I 'm going to Boston tomorrow." "So am I."	"Jeg skal til Boston i morgen." "Jeg også."
"Can you play the guitar?" "Yes , I can."	«Kan du spille gitar?» «Ja , det kan jeg.»
I wish I could figure out how to stop my children from fighting .	Jeg skulle ønske jeg kunne finne ut hvordan jeg får barna mine til å slutte å krangle .
I wish I could make up for lost time .	Jeg skulle ønske jeg kunne gjøre opp for den tapte tiden .
I never even noticed I 'd lost my wallet until I got home .	Jeg merket ikke at jeg hadde mistet lommeboka før jeg først hadde kommet hjem .
Your name has been removed from the list .	Navnet ditt har blitt fjernet fra listen .
"I 'll do it tomorrow." "You said that yesterday!"	"Jeg gjør det i morgen." "Det sa du i går!"
Is there a washing machine in the house ?	Er det en vaskemaskin i huset ?
Wouldn't it be better to do this tomorrow ?	Ville det ikke vært bedre å gjøre dette i morgen ?
All the members were not present at the meeting yesterday .	Ikke alle medlemmer var til stede på møtet i går .
I 'm really sorry that I told you that .	Jeg er skikkelig lei meg for å ha fortalt deg det .
How many cups of coffee does Tom usually drink a day ?	Hvor mange kopper kaffe drikker Tom vanligvis om dagen ?
His sister and I will certainly become good friends .	Søsteren hans og jeg vil nok bli gode venner .
You did n't tell me Tom moved to Boston .	Du fortalte meg ikke at Tom flyttet til Boston .
Tom said he thought we should try to get there early .	Tom sa han mente at vi skulle prøve å dra dit tidlig .
You 're asking me questions you already know the answers to .	Du stiller meg spørsmål som du allerede vet svarene på .
He went to bed because he was tired .	Han gikk og la seg fordi han var trøtt .
You do n't think Tom really could do that , do you ?	Du tror ikke at tom virkelig kunne ha gjort det , gjør du ?
Tom was watching what was happening very carefully .	Tom følgte nøye med på hva som skjedde .
Do you want me to take care of your dog ?	Vil du at jeg skal ta meg av hunden din ?
The ship will arrive in San Francisco this evening .	Skipet ankommer i San Francisco i kveld .
Tom became anorexic when he was in high school .	Tom ble anoreksisk mens han gikk på videregående .
Tom is wearing the same clothes he wore yesterday .	Tom går med de samme klærne han gikk med i går .
What seems easy at first often turns out to be difficult .	Det som ser lett ut ved første øyekast viser seg å være vanskelig .
I took him to the most expensive restaurant on campus .	Jeg tok han med på den dyreste restauranten på campus .
Tom says he 'll do the same thing we do .	Tom sier han vil gjøre det samme som oss .
Never put off until tomorrow what you can do the day after tomorrow .	Utsett aldri til i morgen det du kan gjøre i overmorgen .
A stranger living nearby is better than a relative living far away .	En fremmed som bor i nærheten er bedre enn en slektning som bor langt vekk .
I think you know why I called you .	Jeg tror du vet hvorfor jeg ringte deg .
You do n't have to use a dictionary when you read this book .	Du trenger ikke å bruke ordbok når du leser denne boken .
This is the last time I 'll ask you to do anything .	Dette er siste gang jeg ber deg om å gjøre noe .
I worked as a piano tuner for many years .	Jeg jobber som pianostemmer i mange år .
The weather report says it 'll rain tomorrow afternoon .	Værmeldingen sier at det kommer til å regne i morgen ettermiddag .
If he 'd known the truth , he 'd have told me .	Hvis han hadde visst sannheten , hadde han fortalt meg det .
He was picked up by a passing ship .	Han ble plukket opp av et passerende skip .
I 'm planning to travel to Europe with a friend .	Jeg planlegger å reise til Europa med en venn .
When I was a child , I enjoyed destroying anthills .	Da jeg var et barn , syntes jeg det var gøy å ødelegge maurtuer .
A guide conducted the visitors round the museum .	En guide ledet de besøkende rundt i muséet .
"Pass me the salt , please." "Here you are."	«Send meg saltet , er du snill.» «Vær så god!»
I think that Tom will listen to me .	Jeg tror Tom vil lytte til meg .
If it rains tomorrow , I will stay at home .	Hvis det regner i morgen , blir jeg hjemme .
You do n't think I did it , do you ?	Du tror ikke at jeg gjorde det , gjør du ?
Tom will probably know what needs to be done .	Tom vet nok hva som må gjøres .
Which tie do you think goes best with this shirt ?	Hvilket slips går best med denne skjorten , synes du ?
In the United States , you are a minor if you are under 18 years old .	I USA er du mindreårig dersom du er under 18 år gammel .
We were completely exhausted from the five - hour trip .	Vi var helt utslitte etter fem timers reise .
I 'm afraid I will n't be able to have lunch with you today .	Jeg kan dessverre ikke spise lunsj med deg i dag .
How many cups of coffee does Tom usually drink per day ?	Hvor mange kopper kaffe drikker Tom vanligvis om dagen ?
You do n't look very well. Are you sick ?	Du ser ikke så bra ut. Er du syk ?
The tea is too strong. Add some water .	Teen er for sterk. Tilsett litt vann .
Please do n't tell Tom that you saw me here .	Vær så snill ikke si til Tom at du så meg her .
What can a guy like me do about something like that ?	Hva kan en fyr som meg gjøre med noe sånt ?
This flower is yellow , but all the others are blue .	Denne blomsten er gul , men alle de andre er blå .
Tom is n't used to driving on the left side of the road .	Tom er ikke vant til å kjøre på venstre siden av veien .
Tom talked to Mary about things he usually kept to himself .	Tom snakket med Mary om ting han vanligvis holdt for seg selv .
Do you know how to use this machine ?	Vet du hvordan man bruker denne maskinen ?
We encountered a lot of difficulties on the expedition .	Vi støtte på mange vanskeligheter på ekspedisjonen .
He will take over the business when his father retires .	Han skal ta over firmaet når faren pensjonerer seg .
I do n't feel like doing anything when it 's this hot .	I denne varmen føler jeg ikke for å gjøre noe som helst .
Because of the flood , it was a bad rice - harvest .	På grunn av oversvømmelsen ble det en dårlig rishøst .
I feel very sick. I want to throw up .	Jeg føler meg veldig dårlig. Jeg holder på å spy .
I 'll give you an answer in a day or two .	Jeg vil gi deg svar i løpet av et par dager .
Two years ago Tom and Mary split up , but recently they got together again .	Tom og Mary slo opp for to år siden , men nylig ble de sammen igjen ,
I 'm a little hesitant about asking her for a favor .	Jeg nøler litt med å spørre henne om en tjeneste .
I figured I could be of some help .	Jeg tenkte at jeg kunne være litt til hjelp .
He is apt to say atrocious things and to exaggerate his grievances .	Han er tilbøyelig til å si grusomme ting og overdrive sine klager .
Tom picked out an interesting book for Mary to read .	Tom valgte en interessant bok for Maria .
Tom worked for a construction company in Boston .	Tom jobbet for et byggefirma i Boston .
I am who I am thanks to my mother .	Jeg er den jeg er takket være moren min .
The soldier sacrificed himself to save his friend 's life .	Soldaten ofret seg selv for å redde vennens liv .
I 'm not saying that what she did was right .	Jeg sier ikke at det hun gjorde var riktig .
When you have a question , ask the teacher .	Når du har et spørsmål , spør læreren .
In addition to French , Tom speaks English and German .	I tillegg til fransk snakker Tom engelsk og tysk .
You need good equipment to climb that mountain .	Du trenger godt utstyr for å bestige det fjellet .
I 'm not going to be able to do that .	Jeg vil ikke være i stand til å gjøre det .
Tom thought he had a chance to survive .	Tom trodde han hadde en sjangse til å overleve .
Tom can go with you if he likes .	Tom kan dra med deg hvis han vil .
Tom finished his homework before going to sleep .	Tom gjorde ferdig leksene før han la seg .
Tom 's mother died just one week before Tom graduated from college .	Toms mor døde bare én uke før han ble uteksaminert .
The price was only three thousand yen , or about thirty dollars .	Prisen var bare 3000 yen , altså rundt 30 dollar .
Among other things , we talked about the weather .	Vi snakket blant annet om været .
There is a girl reading under a tree .	Det er en jente som leser under treet .
The captain told us to get off the ship .	Kapteinen ba oss forlate skipet .
Do you mind if I try this on ?	Er det greit om jeg prøver på denne ?
Don't walk so fast. I can n't keep up with you .	Ikke gå så fort. Jeg greier ikke å holde følge med deg .
In the end , Tom had to bite the bullet and take responsibility for his actions .	Tom måtte til slutt bite i det sure eple og ta ansvar for sine handlinger .
You do n't like living with your parents , do you ?	Du liker ikke å bo med foreldrene dine , ikke sant ?
There 's nothing I want to say to you .	Det er ingenting jeg ønsker å si til deg .
I should n't have to go to the dentist again for a while .	Jeg skulle ikke trenge å måtte gå til tannlegen på en stund .
I do n't want to go to school today .	Jeg vil ikke gå på skolen i dag .
Tom should have been eating more vegetables and not as much meat .	Tom skulle ha spist mer grønnsaker og ikke så mye kjøtt .
"How did you get in here?" "I climbed in through the window."	"Hvordan kom du deg inn her?" "Jeg klatret gjennom vinduet."
Is it necessary to make so much noise ?	Er det nødvendig å lage så mye støy ?
As far as I know , the novel is not translated into Japanese .	Så vidt jeg vet har ikke romanen blitt oversatt til japansk .
History is like a waltz , eternally following the three steps of war , peace and revolution .	Historien likner vals: den følger evig de tre trinnene krig , fred og revolusjon .
I can give you some money if you need it .	Jeg kan gi deg litt penger om det trengs .
"I 'm not good at swimming." "Neither am I."	"Jeg er ikke så flink til å svømme." "Ikke jeg heller."
I wish I had gone to the theater last night .	Jeg skulle ønske jeg hadde dratt til teateret i går kveld .
I buried my dog at the pet cemetery .	Jeg begravet hunden min på dyrekirkegården .
If you treat a customer well , he 'll be a customer for life .	Hvis du behandler en kunde bra , vil han være kunde for livet .
Most computers made today are equipped with multi - core processors .	De fleste datamaskiner som lages i dag er utstyrt med flerkjerneprosessorer .
I can n't figure out the answer to this problem .	Jeg klarer ikke å finne ut hvordan jeg løser dette problemet .
How often do you write letters in French ?	Hvor ofte skriver du brev på fransk ?
Tom 's an irritating person to work with because he 'll never admit it when he 's made a mistake .	Det er irriterende å jobbe med Tom fordi han aldri innrømmer sine feil .
Your wish will come true in the near future .	Ønsket ditt vil gå i oppfyllelse i nær framtid .
It was n't Tom who left the water running .	Det var ikke Tom som glemte å stenge kranen .
From the bottom of my heart , thank you .	Hjertelig takk .
Didn't it occur to you to shut the windows ?	Tenkte du ikke på å stenge vinduene ?
Air as well as sunlight is , needless to say , indispensable to our daily life .	At luft så vel som sollys er uunnværlig , sier seg selv .
You do n't think Tom will call again , do you ?	Du tror ikke at Tom vil ringe igjen , gjør du ?
Would you be so kind as to turn the light on ?	Kunne du være så snill og slå på lyset ?
How come you did n't call me last night ?	Hvorfor ringte du meg ikke i går kveld ?
Tom has as many stamps as I do .	Tom har like mange frimerker som meg .
Excuse me , I have to get to Barcelona. Are there any flights today ?	Unnskyld , jeg må til Barcelona. Er det noen flyavganger i dag ?
I still do n't know why you did n't do that .	Jeg vet fortsatt ikke hvorfor dere ikke gjorde det .
I wish I could come up with a good answer to the question .	Jeg skulle ønske jeg kunne finne et godt svar på det spørsmålet .
How much time do you spend on Facebook ?	Hvor mye tid bruker du på Facebook ?
"Are you and Tom still together?" "No , we split up at the beginning of last month."	"Er du fremdeles sammen med Tom?" "Nei , vi slo opp i begynnelsen av forrige måned."
We have a busy day ahead of us .	Vi har en travel dag foran oss .
I do n't want to hear any more of your complaining .	Jeg vil ikke høre mer på klagingen din .
This temple is said to have been built over 500 years ago .	Det sies at dette tempelet ble bygd for over 500 år siden .
You do know that Tom and Mary broke up , do n't you ?	Du vet at Tom og Mary slo opp , ikke sant ?
This has been a tough week for Tom .	Dette har vært en tøff uke for Tom .
There are lots of things for us to think about .	Det er mange ting vi må tenke på .
All three of my sons were born in Australia .	Alle tre sønnene mine ble født i Australia .
Tom said that he thought he 'd forgotten to lock the door .	Tom sa at han trodde han hadde glemt å låse døren .
You had better ask him in advance how much it will cost .	Du bør spørre ham på forhånd hvor mye det vil koste .
You can get this medicine without a prescription .	Du kan skaffe denne medisinen uten resept .
I saw Tom out of the corner of my eye .	Jeg så Tom ut av øyekroken .
The teacher was very fair when she marked our exams .	Læreren var veldig rettferdig da hun satte eksamenskarakterene .
I saw my neighbor 's dog running around in the yard .	Jeg så naboens hund løpe rundt på gårdsplassen .
"I 'm getting hungry." "Me , too." "Do you want to eat?" "OK."	"Jeg er sulten." , "Jeg også" , "Skal vi spise?" , "Ok."
I do n't have any friends to talk to .	Jeg har ingen venner å snakke med .
Tom decided not to tell his parents about what had happened .	Tom bestemte seg for å ikke fortelle foreldrene sine hva som hadde hendt .
The soldier sacrificed himself to save his friend 's life .	Soldaten bøtet med livet for å redde vennens liv .
It would be nice if Tom did n't keep making unnecessary remarks .	Det hadde vært fint om Tom kunne sluttet å komme med unødvendige bemerkninger .
We need to do something about this soon .	Vi må gjøre noe med dette snart .
If it were not for water , no living things could live .	Var det ikke for vann , ville det ikke vært noe liv .
When I got home , I found I had lost my wallet .	Da jeg kom hjem , oppdaget jeg at jeg hadde mistet lommeboken min .
I wish I could figure out how to delete my Facebook account .	Jeg skulle ønske jeg kunne finne ut hvordan jeg kan slette facebookkontoen min .
I 'll postpone my trip to England until it gets warmer .	Jeg utsetter turen til England frem til det blir varmere .
Tom had nothing to do with the kidnapping .	Tom hadde ingenting med kidnappingen å gjøre .
I thought that Tom was rich , but I was wrong .	Jeg trodde at Tom var rik , men jeg tok feil .
He knows very well how to deceive people .	Han vet veldig godt hvordan man lurer folk .
Tom said he hoped that Mary would come to his party .	Tom sa at han håpet Mary ville komme til festen hans .
Tom did n't even notice that Mary was flirting with him .	Tom merket ikke engang at Mary flørtet med han .
Tom says that he has to borrow some money .	Tom sier at han må låne noe penger .
We need to see each other more often .	Vi må treffes oftere .
When we borrow money , we must agree on the conditions .	Når man ber om penger , må man akseptere visse betingelser .
That sound annoyed me at first , but now I 've gotten used to it .	Den lyden irriterte meg til å begynne med , men nå har jeg blitt vant til den .
His plane leaves for Hong Kong at 2:00 p.m .	Flyet hans tar av mot Hong Kong kl. 14.00 .
I do n't remember the last time I had so much fun .	Jeg kan ikke huske sist jeg hadde så mye morro .
People were lined up around the block waiting for the theater to open .	Folk stod i kø rundt blokken mens de ventet på at teateret skulle åpne .
This is the first time I 've seen anything like this .	Det er første gang jeg har sett noe sånt .
Do you go to the post office often ?	Besøker du ofte postkontoret ?
I wish you could be a little quieter .	Jeg skulle ønske at du kunne vært litt mer stille .
Tom will try to be there on time .	Tom skal prøve å være der presis .
If you could live anywhere in the world , where would you want to live ?	Hvis du kunne bo hvor som helst i verden , hvor ville du ha bodd ?
I can assure you that honesty pays in the long run .	Jeg kan forsikre deg om at ærlighet lønner seg i det lange løp .
The older you are , the more difficult it is to learn a language .	Jo eldre du er , desto vanskeligere er det å lære et språk .
Which came first , the chicken or the egg ?	Hva kom først , kyllingen eller egget ?
Of the 23 who were arrested , four escaped .	Av de tjuetre som ble arrestert , rømte fire .
I live near the sea , so I often get to go to the beach .	Jeg bor nær sjøen , så jeg får ofte dratt til stranden .
How do I get to the bus station ?	Hvordan kommer jeg meg til busstasjonen ?
I was nearly run over by a truck .	Jeg ble nesten påkjørt av en lastebil .
Tom is standing in the middle of the room .	Tom står midt i rommet .
I used to be thin when I was young .	Jeg var tynn som ung .
Tom is doing everything he can for Mary .	Tom gjør alt han kan for Mary .
He chose to live in Tokyo instead of Osaka .	Han valgte å bo i Tokyo og ikke i Osaka .
I 'm going to work out the problem by myself .	Jeg kommer til å løse problemet selv .
March is the third month of the year .	Mars er den tredje måneden i året .
Are you sure what you 're saying is true ?	Er du sikker på at det du sier stemmer ?
I 'll show you the books that Tom gave me .	Jeg skal vise deg bøkene som Tom ga meg .
Tom thought the house Mary wanted to buy was a little too small .	Tom syntes huset Maria hadde lyst til å kjøpe var litt lite .
She has made up her mind to go to America to study .	Hun har bestemt seg for å dra til Amerika for å studere .
Fish is an important food source for people .	Fisk er en viktig matkilde for folk .
Resentment is like drinking poison , and then hoping it will kill your enemy .	Avsky er som å drikke gift , og deretter håpe at det vil drepe din fiende .
The average American living space is twice as large as the living space in Japan .	Det gjennomsnittlige amerikanske boarealet er dobbelt så stort som det japanske .
Doctors have offered me nothing but sleeping pills .	Legene har ikke tilbytt meg noe annet enn sovetabletter .
I do n't have as much money as you think .	Jeg har ikke så mye penger som du tror .
Tom noticed Mary was n't wearing the ring he 'd given her .	Tom merket at Mary ikke gikk med ringen han hadde gitt henne .
No one can force us to do that .	Ingen kan tvinge oss til å gjøre det .
If only the doctor had come a little sooner .	Om bare legen hadde kommet litt fortere .
It was this boy that broke the windowpane .	Det var denne gutten som knuste vindusruten .
Are you sure that you can find your way home ?	Er du sikker på du finner veien hjem ?
He began to suspect something was wrong when the seller did n't allow him to test the item before buying it .	Han begynte å lukte ugler i mosen når selgeren ikke ville la ham teste produktet før han kjøpte det .
There was a large audience at yesterday 's concert .	Det var en stor tilskuermengde på gårsdagens konsert .
You 'll be able to drive a car in a few days .	Du vil kunne kjøre bil etter noen dager .
I 've had it with you and your stupid ideas .	Jeg har fått nok av deg og dine dumme idéer .
The plane had already taken off when I reached the airport .	Da jeg ankom på flyplassen , hadde flyet allerede lettet .
I 'll be getting off at the next stop .	Jeg vil gå av på neste stopp .
Tom works as hard as any boy in the class .	Tom arbeider like så flittig som noen annen gutt i klassen .
Make sure you get a good night 's sleep .	Husk å få deg en god natts søvn .
The mere sight of a snake makes her sick .	Hun blir dårlig bare ved synet av en slange .
I bought a flashlight , but I forgot to buy batteries .	Jeg kjøpte en lommelykt , men jeg glemte å kjøpe batterier .
Tom understood why Mary did n't want to go to Australia with him .	Tom forsto hvorfor Mary ikke ville dra til Australia med ham .
Tom pulled out a whistle and blew it .	Tom tok frem en fløyte og blåste i den .
It 's a pity that you could n't be there .	Det er synd at du ikke kunne være der .
Some guy named Tom said he was looking for you .	En fyr kalt Tom sa at han så etter deg .
I require absolute loyalty from all my employees .	Jeg krever absolutt lojalitet fra alle mine ansatte .
Recently the demand for this product has increased faster than the supply .	Etterspørselen etter dette produktet har vokst raskere enn tilbudet i det siste .
Tom did n't want to talk about that over the phone .	Tom ville ikke snakke om det over telefonen .
I wish I had enough time to sleep .	Jeg skulle ønske jeg hadde hatt nok tid til å sove .
I do n't remember ever seeing one of these before .	Jeg kan ikke huske å ha sett en av disse før .
It 's OK with me if it 's OK with you .	Der er ok for meg hvis det er ok for deg .
I do n't think Tom likes you the way you like him .	Jeg tror ikke Tom liker deg på samme måte som du liker ham .
The surgeon persuaded me to undergo an organ transplant operation .	Kirurgen overtalte meg til å undergå en organtransplantasjon .
I 'm afraid I 'm not familiar with that expression .	Det uttrykket er meg desverre ikke bekjent .
I burned all the letters that you wrote me .	Jeg brant alle brevene du skrev meg .
Not a star was to be seen that night .	Det var ikke en stjerne å se den natten .
How much did you have to pay to get your truck fixed ?	Hvor mye måtte du betale for å få bilen din reparert ?
I do n't know what I want to do .	Jeg vet ikke hva jeg vil gjøre .
Tom works out in a gym near his house .	Tom trener på et treningssenter nært huset hans .
You 're in luck. The plane is on time .	Nå var du heldig. Flyet kommer i tide .
I wish I could tell you all the details , but my boss told me not to .	Jeg skulle ønske jeg kunne fortelle deg alle detaljene , men sjefen min sa at jeg ikke skulle .
I 'm sorry , but I do n't understand French well .	Beklager , men jeg forstår ikke fransk så godt .
Kissing a person who smokes is like licking an ashtray .	Å kysse en person som røyker er som å slikke et askebeger .
Mary suffered from severe postnatal depression after the birth of her first child .	Mary led av alvorlig postnatal depresjon etter å ha født hennes første barn .
My teacher told me to turn in my paper as soon as possible .	Læreren min sa jeg skulle levere inn oppgaven min så fort som mulig .
I look forward to hearing your thoughts on this matter .	Jeg ser frem til å høre din tanker om denne saken .
Why does n't Tom just buy a new one ?	Hvorfor kjøper ikke bare Tom en ny ?
Tom showed me a picture of his house .	Tom viste meg et bilde av huset sitt .
I really like the concept of this website .	Jeg liker virkelig konseptet for denne nettsiden .
"When will you be back?" "It all depends on the weather."	"Når er du tilbake?" "Det avhenger av været."
It was obvious it would be this way .	Det var åpenbart at det var slik det kom til å være .
I prefer to take a shower in the morning .	Jeg foretrekker å dusje om morgenen .
Germany adopted a social security system in the 1880 's .	Tyskland vedtok et trygdesystem i 1880 - årene .
He quickly scanned the page for the word he was looking for .	Han skummet raskt over siden etter ordet han lette etter .
A violinist I know says that he owns a Stradivarius .	En fiolinist jeg kjenner sier at han eier en Stradivarius .
I heard a dog barking in the distance .	Jeg hørte en hund gjø i det fjerne .
Tom intended to ask his boss for a raise , but he reconsidered .	Tom hadde tenkt å be sjefen om en lønnsøkning , men han ombestemte seg .
The prince fell in love with a woodcutter 's daughter .	Prinsen forelsket seg i en tømmerhuggers datter .
Tom and I 've known each other for a long time .	Tom og jeg har kjent hverandre lenge .
Tom said he did n't know why Mary wanted to break up with him .	Tom sa at han ikke visste hvorfor Mary ville slå opp med ham .
Today 's math class was more interesting than usual .	Dagens mattetime var mer interessant enn vanlig .
But what will you do if he does n't come ?	Men hva gjør du hvis han ikke kommer ?
Because of the bad weather , the plane 's departure was delayed by two hours .	På grunn av det dårlige været ble flyets avgang forsinket med to timer .
Why do you want to be a nurse ?	Hvorfor vil du bli sykepleier ?
Tom smiled when he realized Mary was about to kiss him .	Tom smilte da han innså at Mary var i ferd med å kysse ham .
We were tired out after our long walk .	Vi var utslitte etter den lange gåturen .
Do you promise not to tell anyone else ?	Lover du at du ikke forteller noen andre ?
I know better than to borrow money from friends .	Jeg vet bedre enn å låne penger fra venner .
Please wake me up at seven tomorrow morning .	Vekk meg klokken syv i morgen , er du snill .
Do you have a similar saying in Japanese ?	Finnes det et tilsvarende ordtak på japansk ?
Tom will remember this weekend as long as he lives .	Tom kommer til å huske denne helgen for resten av livet .
He did n't show up at the party yesterday evening .	Han viste seg ikke på festen i går kveld .
Your mother must 've been beautiful when she was young .	Din mor må ha vært vakker som ung .
The British troops fought hard , but could not stop the Germans .	De britiske troppene kjempet hardt , men klarte ikke å stoppe tyskerne .
Can you imagine what our lives would be like without electricity ?	Kan du forestille deg hvordan livene våre hadde vært uten elektrisitet ?
Tom definitely should have gotten the death sentence .	Tom burde definitivt ha fått dødsstraff .
Zamenhof , the creator of Esperanto , was an ophthalmologist .	Zamenhof , skaperen av det konstruerte språket esperanto , var en øyelege .
How often do you go to the beach ?	Hvor ofte drar du på stranda ?
He earns more money than he can spend .	Han tjener mer penger enn han kan bruke .
You do n't want to go to prison , do you ?	Du vil ikke i fengsel , gjør du ?
Tom wishes he did n't have to help with the housework .	Tom skulle ønske han ikke måtte hjelpe til med husarbeidet .
I think the love of money is common to us all .	Jeg tror det å elske penger , er noe vi alle har til felles .
Tom went to school to learn how to tune pianos .	Tom drog til en skole for å lære hvordan å stemme pianoer .
Tom 's plane leaves for Boston at 2:30 p.m .	Flyet Tom skal ta til Boston drar kl. 14.30 .
Tom told Mary what he needs her to do .	Tom fortalte Maria hva han ville ha henne gjøre .
We have a lot more beer in the refrigerator .	Vi har mye mer øl i kjøleskapet .
This guitar is so expensive that I can n't buy it .	Denne gitaren er så dyr at jeg ikke kan kjøpe den .
I can n't get that thought out of my head .	Jeg kan ikke få den tanken ut av hodet .
Which do you like better , the sea or the mountains ?	Hvilken liker du best , fjell eller sjø ?
I want to be a teacher in the future .	Jeg vil bli lærer i fremtiden .
Albert Einstein was born in Ulm in 1879 .	Albert Einstein ble født i Ulm i 1879 .
Picasso kept drawing pictures until he was 91 years old .	Picasso fortsatte å male bilder til han ble 91 år gammel .
There 's a possibility that the man was murdered .	Det er en mulighet for at mannen ble myrdet .
The worst they can do is shoot me .	Det verste de kan gjøre er å skyte meg .
There are n't any fish living in this river anymore .	Det lever ikke lenger fisk i denne elven .
I 'll postpone my trip to England until it gets warmer .	Jeg utsetter turen min til England til det blir varmere .
He worked so hard that he ruined his health .	Han jobbet så hardt at han ødela helsen sin .
I 've had enough of trying to deal with other people 's problems .	Jeg har fått nok av å hanskes med andre folks problemer .
The man reading a paper over there is my uncle .	Mannen som leser avisen der borte er min onkel .
We 've known about that for a long time .	Vi har visst om det lenge .
You should n't have done that without asking Tom if it was OK .	Du burde ikke ha gjort det uten å spørre Tom om det var greit .
The dentist told me to open my mouth .	Tannlegen ba meg åpne munnen .
I can n't drive anywhere because my car 's out of gas .	Jeg kan ikke kjøre noe sted fordi bilen min er tom for bensin .
The magician asked for a volunteer from the audience .	Tryllekunstneren spurte etter frivillige blant publikum .
Tom seemed surprised when I told him about it .	Tom så overrasket ut når jeg fortalte ham om det .
Tom has as many books as I do .	Tom har like mange bøker som meg .
I 'll ask Tom to give me some money .	Jeg skal spørre Tom om han ikke kan gi meg litt penger .
Tom would have missed the train if he had stopped to buy a chocolate bar .	Tom ville ha mistet toget om han hadde stoppet for å kjøpe en sjokolade .
Tom said that he thinks Mary will n't want to go swimming with us .	Tom sa at han ikke tror Maria vil være med oss og svømme .
Tom was upset when I told him about what had happened .	Tom ble opprørt da jeg fortalte ham om hva som hadde skjedd .
He is the shorter of the two boys .	Han er den korteste av de to guttene .
Thanks a lot for all the things you 've done for me .	Tusen takk for de utallige tingene du har gjort for meg .
You were supposed to be there by 2:30 .	Du skulle vært der innen 2:30 .
Is this ladder strong enough to bear my weight ?	Er denne stigen solid nok til å bære meg ?
Tom said it could take a few hours to do it .	Tom sa at det kan ta noen timer å gjøre det .
I just got off the phone with my agent .	Jeg telefonerte nettopp med agenten min .
After the accident , they connected him to a lot of machines .	Etter ulykken , koblet de han opp mot masse maskiner .
Did you know that Tom lived in Australia for three years ?	Visste du at Tom bodde i Australia i tre år ?
I was a first year student last year .	Jeg var førsteårsstudent i fjor .
Life begins when you 're ready to live it .	Livet begynner når du er klar for å leve .
My driving instructor says I should be more patient .	Kjørelæreren min sier jeg bør være mer tålmodig .
I 'd like to be a dentist in the future .	I fremtiden vil jeg bli tannlege .
What do you plan to do on Friday ?	Hva har du tenkt til å gjøre på fredag ?
There are times when I find you really interesting .	Av og til synes jeg du er veldig interessant .
I 'm afraid I 'll have to disappoint you. I do n't feel like participating in this discussion .	Jeg må dessverre skuffe deg. Jeg føler ikke for å delta i diskusjonen .
I 've got better things to do with my time than to sit here and listen to you complain .	Jeg har bedre ting å gjøre enn å sitte her og høre på at du klager .
I know some of you want to go back to the way things were , but that 's not going to happen .	Jeg vet at noen av dere ønsker å gå tilbake til slik ting var før , men det kommer ikke til å skje .
Tom has n't yet told us what he needs .	Tom har ikke fortalt oss hva han trenger enda .
Remember to check to make sure the gas has been turned off before you go out .	Husk å sjekke om gassen har blitt skrudd av før du går ut .
I just got off the phone with my lawyer .	Jeg telefonerte nettop med advokaten min .
Today 's math class was more interesting than usual .	Dagens mattetime var gøyere enn vanlig .
He never fails to give her a birthday present .	Han gir henne alltid en gave på fødselsdagen .
When I was little , I believed in Santa .	Når jeg var liten trodde jeg på julenissen .
Tom went for three weeks without shaving before his wife complained .	Tom gikk tre uker uten å barbere seg før kona klagde .
How can you tell good English from bad English ?	Hvordan kan en se forskjell på god og dårlig engelsk ?
They sound so similar it 's not easy to distinguish them .	De høres så like ut at det ikke er lett å skille dem .
What 're you going to do during your summer vacation ?	Hva skal du gjøre i sommerferien ?
Tom is apparently some kind of genius when it comes to music .	Tom er tydeligvis et slags geni når det gjelder musikk .
It is still unclear what caused the accident .	Ulykkesårsaken er ennå ikke klar .
The letter Tom received said that he should return home as soon as possible .	Brevet Tom fikk sa han burde komme hjem igjen fortest mulig .
John and Mary have known each other since 1976 .	John og Mary har kjent hverandre siden 1976 .
Even the experts took the painting for a genuine Rembrandt .	Selv eksperter tok maleriet for å være en ekte Rembrandt .
It is important to try to get along with people from foreign countries .	Det er viktig å prøve å komme overens med folk fra andre land .
It was disappointing that nobody ate the expensive sushi I had served .	Jeg ble så skuffet over at ingen spiste den dyre sushien som jeg hadde servert .
I think your English has improved a lot .	Jeg synes du har blitt mye bedre i engelsk .
I have plenty of time , but not enough money .	Jeg har mer enn nok tid , men ikke nok penger .
They cut a hole in the ice and swam in the freezing water .	De kuttet et hull i isen og svømte i det iskalde vannet .
Tom found a house that he wants to buy .	Tom fant et hus han vil kjøpe .
He did n't come back to the base yesterday .	Han kom ikke tilbake til basen i går .
It is said that women live longer than men .	Det sies at kvinner lever lenger enn menn .
I 'm sorry. I wish I could take back what I said .	Unnskyld. Jeg skulle ønske jeg kunne tatt tilbake det jeg sa .
I lived in Tokyo a few years ago , but now I live in Kyoto .	Jeg bodde i Tokyo for noen år siden , men nå bor jeg i Kyoto .
Without the map , he would have gotten lost .	Uten det kartet , ville han nok ha gått seg vill .
I need to talk to you about something personal .	Jeg må snakke med deg om noe personelig .
The next morning , the snowman had completely melted .	Neste morgen hadde snømannen smeltet helt .
It seems that both Tom and Mary like classical music .	Det ser ut som både Tom og Mary liker klassisk musikk .
She spoke too quickly , so I could n't understand .	Hun snakket for fort , slik at jeg ikke forstod .
I had my tonsils removed two weeks ago .	Jeg fjernet mandlene mine for to uker siden .
If you keep spending money like that , you 'll be broke before you know it .	Hvis du fortsetter å bruke penger på den måten , vil du være blakk før du vet ordet av det .
I wish I had gone with the others to the game yesterday .	Jeg skulle ønske jeg hadde dratt med de andre til kampen i går .
I 'm not stupid. I 'm just bad at math .	Jeg er ikke dum. Jeg er bare dårlig i matte .
Carbon monoxide is a poisonous substance formed by the incomplete combustion of carbon compounds .	Karbonmonoksid er et giftig stoff som dannes ved ufullstendig forbrenning av karbonforbindelser .
What time do you think Tom will be back ?	Når tror du at Tom vil være tilbake ?
The apple does n't fall far from the tree .	Eplet faller ikke langt fra stammen .
You do n't like Tom very much , do you ?	Du liker ikke akkurat Tom veldig mye , gjør du ?
Tom is wearing the same clothes that he wore yesterday .	Tom går med de samme klærne han gikk med i går .
Having done my homework , I could finally watch television .	Etter at jeg hadde gjort leksene mine kunne jeg endelig se på TV .
They had n't gone very far when they met an old man .	De hadde ikke gått langt , før de møtte en gammel mann .
It 's hard to predict what the weather will be like tomorrow .	Det er vanskelig å forutsi hvordan været vil være i morgen .
The closer you are to the sea , the windier it gets .	Det nærmere du er havet , det mer blåser det .
I wish that I had stuck around long enough to meet your parents .	Jeg skulle ønske jeg hadde blitt lenge nok til å møte foreldrene dine .
I might have to get my tonsils out .	Det er mulig jeg må fjerne mandlene mine .
When I entered the room , Tom and Mary were laughing at something .	Da jeg gikk inn i rommet , lo Tom og Mary av noe .
I 'm not sure if that 's a good idea .	Jeg vet ikke om det er en god idé .
Where is the most beautiful place in the world ?	Hvor er det vakreste stedet i verden ?
You do n't know what you want , do you ?	Du vet ikke hva du vil , ikke sant ?
By chance , I met her in the street .	Jeg traff henne tilfeldigvis på gaten .
I wish I had bought a concert ticket .	Jeg skulle ønske jeg hadde kjøpt en bilett til konserten .
O positive is the most common blood type .	O+ er den vanligste blodtypen .
Can you tell me how you get to the American Embassy ?	Kan du si meg hvordan man kommer til den amerikanske ambassaden ?
I wish I could tell you the reason , but I can n't .	Jeg skulle ønske jeg kunne si deg hvorfor , men jeg kan ikke .
I wish I had a little more time to finish this .	Jeg skulle ønske jeg hadde litt mer tid til å bli ferdig med dette .
He has not come yet. Something may have happened to him .	Han har ikke kommet enda. Kanskje noe har hendt ham .
Tom 's eyesight is n't as good as it used to be .	Tom hadde bedre syn før i tiden .
You have to do it , whether you like it or not .	Du må gjøre det , enten du vil eller ikke .
Do you want to learn to play guitar ?	Vil du lære å spille gitar ?
Tom would n't mind eating meat and potatoes every day of the week .	Tom kunne gjerne ha spist kjøtt og poteter hver dag i uken .
"Perhaps we 'd better not tell Tom anything about today." "I agree."	"Kanskje vi ikke bør fortelle Tom noe om i dag." "Jeg er enig."
I asked him if he would scratch my back .	Jeg spurte ham om han ville klø meg på ryggen .
How many of the words on this list do n't you know ?	Hvor mange av ordene på denne listen kjenner du ikke ?
It is an advantage to be able to use a computer .	Det er en fordel å kunne bruke en datamaskin .
We 're going to Tom 's birthday party tomorrow , right ?	Vi drar på bursdagsfesten til Tom i morgen , ikke sant ?
My father is a native French speaker and my mother is a native English speaker .	Faren min har fransk som morsmål , og moren min har engelsk som morsmål .
I spent the whole weekend at home on the computer .	Jeg satt hjemme på pc - en hele helgen .
Do you have any idea who 's in the next room ?	Har du en anelse om hvem som er i naborommet ?
I 'm expecting a baby in the new year !	Jeg venter barn på nyåret !
Tom 's opinions do n't carry much weight around here .	Toms meninger har ikke særlig betydning her .
You were supposed to be here by 2:30 .	Du skulle vært her innen 2:30
It was very cold and it snowed for three days in a row .	Det var veldig kaldt , og det snødde i tre dager .
It makes no difference to me whether you are rich or poor .	Det er det samme for meg om du er rik eller fattig .
Every time I see this picture , I remember my father .	Når jeg ser dette bildet , minnes jeg alltid min far .
I should n't have put my laptop so close to the edge of the table .	Jeg skulle ikke ha puttet den bærbare datamaskinen min så nærme bordkanten .
I think that it 's time for me to get a dog .	Jeg tror det er på tide at jeg skaffer meg en hund .
I just ran into Tom in the cafeteria .	Jeg traff akkurat på Tom i kafeteriaen .
I can n't recall her name at the moment .	Jeg kan ikke huske navnet hennes for øyeblikket .
Are you in a bad mood or something ?	Er du i dårlig humør , eller ?
In retrospect , Tom wishes he had spent more time studying .	I retrospekt , skulle Tom ønske han hadde brukt mer tid på å studere .
Tom thinks that women in America wear too much perfume .	Tom synes at kvinner i Amerika bruker for mye parfyme .
It might help if you were the one who told Tom not to do that .	Det hjelper kanskje hvis det er du som sier til Tom at han ikke skal gjøre det .
I have no wish to live in a large city .	Jeg har ikke noe lyst til å bo i en storby .
You should go to the dentist and have that tooth pulled out .	Du bør gå til tannlegen og få den tannen trukket .
We took a short rest on the way .	Vi tok en liten hvilepause på veien .
My father writes in his diary every day .	Pappa skriver i dagboken sin hver dag .
Tom told Mary he could n't do what she asked him to do .	Tom sa til Mary at han ikke kunne gjøre det hun spurte ham om .
What is it you really want to tell me ?	Hva er det du har så lyst å fortelle meg ?
Are you sure you want me to sell this ?	Er du sikker på at du vil jeg skal selge dette ?
If Tom shows up , it 's going to ruin Mary 's day .	Hvis Tom kommer , vil det ødelegge dagen til Mary .
You do n't have to go unless you want to .	Du trenger ikke gå med mindre du vil .
I was worried you would n't be able to do that .	Jeg var bekymret for at du ikke ville klare det .
There 's no speed limit on the Autobahn in Germany .	Det er ingen fartsgrense på Autobahn i Tyskland .
He took charge of the family business after his father died .	Han tok over styringen av familiebedriften etter hans far døde .
In America , you are a minor if you are under 18 years old .	I USA er du mindreårig dersom du er under 18 år gammel .
I can n't tell you exactly how long it will take .	Jeg kan ikke si nøyaktig hvor lang tid det vil ta .
The robots never get sick or complain and they can work 24 hours a day .	Robotene blir aldri syk og klager aldri , og de kan jobbe 24 timer om dagen .
The man left the restaurant without paying his bill .	Mannen dro fra restauranten uten å betale regningen .
He made us work till late at night .	Han fikk oss til å jobbe langt ut på natt .
Tom tried to kiss me , but I did n't let him .	Tom prøvde å kysse meg , men jeg lot ham ikke .
How many times did you see the movie ?	Hvor mange ganger så du filmen ?
Switzerland is situated between France , Italy , Austria and Germany .	Sveits ligger mellom Frankrike , Italia , Østerrike og Tyskland .
I used to eat pizza , but now I do n't .	Jeg pleide å spise pizza før , men aldri nå lenger .
They lived in a very small house at the end of a long , gray street .	De bodde i et veldig lite hus , på enden av en lang , grå gate .
Do you understand what I want to say ?	Forstår du hva jeg vil si ?
The storm did great damage to her property .	Stormen gjorde stor skade på eiendomen hennes .
When I entered the room , she was playing the piano .	Hun spilte piano da jeg gikk inn i rommet .
The whale is a very large mammal that lives in the sea .	Hvalen er et veldig stort pattedyr som lever i sjøen .
How many cups of coffee does Tom usually drink per day ?	Hvor mange kopper kaffe drikker Tom vanligvis per dag ?
I wish we did n't have to do this anymore .	Jeg skulle ønske vi ikke måtte gjøre dette mer .
Which CD do you want to listen to ?	Hvilken CD vil du høre på ?
The flash was n't working , so he could n't take a picture in the dark .	Blitsen funket ikke , så han kunne ikke ta bilde i mørket .
If it had not been for her advice , he would have failed .	Hvis det ikke hadde vært for hennes råd , ville han ha mislyktes .
If you have an indoor swimming pool , you 're probably pretty rich .	Har du et innendørs badebasseng , er du sannsynligvis ganske rik .
The capital of Mexico is the largest city in Latin America .	Hovedstaden i Mexico er den største byen i Latin - Amerika .
He has n't come yet. He must have missed the bus .	Han har ikke kommet enda. Han må ha mistet bussen .
Five thousand dollars is a large sum of money .	Fem tusen dollar er mye penger .
Were I to die , who would look after my children ?	Hvem ville tatt vare på barna mine om jeg døde ?
I called and pretended that I was Tom .	Jeg ringte og latet som om jeg var Tom .
I 've been in love with you for a long time .	Jeg har vært forelsket i deg lenge .
People might think you 're stupid if you do that .	Hvis du gjør det kommer folk til å tro at du er dum .
How many cups of coffee did you drink ?	Hvor mange kopper kaffe drakk du ?
He kept me waiting there for more than an hour this afternoon .	Han lot meg vente der i mer enn en time i ettermiddag .
You 're the only person I know who does n't take some kind of medicine at least once a week .	Du er den eneste personen jeg kjenner som ikke tar en eller annen medisin minst en gang i uken .
I took a taxi so I could catch the train .	Jeg tok en drosje for å nå toget .
I thought that you said Tom was a friend of yours .	Jeg trodde du sa at Tom var en venn av deg .
You 'll get there in time , so long as you do n't miss the train .	Du kommer fram i tide så lenge du rekker toget .
Tom was the only man at the company that Mary respected .	Tom var den eneste mannen i firmaet som Mary respekterte .
My mother bought two bottles of orange juice .	Min mor kjøpte to flasker appelsinjuice .
I wish you would tell me what I ought to do in this difficult situation .	Jeg skulle ønske at du kunne fortalt meg hva jeg burde gjøre i denne vanskelige situasjonen .
She promised to meet him at the coffee shop .	Hun lovet å møte ham i kaffebaren .
I do n't want to go to the beach .	Jeg vil ikke gå til stranden .
You can use my car , if you want to .	Du kan bruke bilen min , hvis du vil .
Both Tom and Mary checked their own watches .	Både Tom og Mary sjekket sine egne klokker .
I knew you were n't going to be punished .	Jeg visste du ikke ville bli straffet .
They say that the movie is an interesting one .	De sier at filmen er en interessant en .
It was not until I left school that I realized the importance of study .	Først etter å ha fullført utdannelsen min innså jeg hvor viktig det er å studere .
I do n't have to apologize for what I said .	Jeg trenger ikke å unnskylde for det jeg sa .
This is a secret , so please do n't tell anyone .	Dette er en hemmelighet , så vær så snill ikke si det til noen .
A working man should be paid in proportion to his skill , not his age .	Arbeidere burde ikke lønnes i forhold til sin alder , men i forhold til sine ferdigheter .
I suggest we both leave now and leave Tom and Mary to discuss this problem on their own .	Jeg foreslår at vi begge går nå , og lar Tom og Mary diskutere dette problemet på egen hånd .
Tom 's mother chased Tom as he ran naked around the lobby .	Tom ble jaget av moren sin mens han løp naken rundt i lobbyen .
Tom has begun looking for a new job .	Tom har begynt å se etter ny jobb .
Is it true that you were n't here yesterday ?	Er det sant at du ikke var her i går ?
You should n't tell him anything about your girlfriend .	Du bør ikke fortelle ham noe om kjæresten din .
Without the ozone layer , we would be in danger .	Uten osonlaget ville vi vært i fare .
However cold it may be , he still jogs 20 kilometers every day .	Uansett hvor kaldt det er , så jogger han 20 kilometer hver dag .
Tom said he thought the pilot was drunk .	Tom sa han trodde piloten var full .
It was a window that Tom broke yesterday .	Det var et vindu Tom ødela i går .
Please turn off the lights when you leave the room .	Slå av lyset før du forlater rommet .
Did you really go to Boston last weekend ?	Reiste du virkelig til Boston sist helg ?
He wondered how many times the sun would rise before his salary would .	Han lurte på hvor mange ganger solen ville stige før lønnen hans ville stige .
My dog follows me whenever I leave the room .	Hunden min følger alltid etter meg når jeg går ut av rommet .
Tom has n't yet told us what he wants us to do .	Tom har ikke fortalt oss hva han vil at vi skal gjøre enda .
The doctor arrived in the nick of time .	Legen kom i siste øyeblikk .
Tom is obviously glad that that has happened .	Tom er åpenbart glad for at det har skjedd .
There used to be a large park here .	Det pleide å være en stor park her .
I know that Tom is a prison guard .	Jeg vet at Tom er fengselsvakt .
I take it you do n't approve of the way Tom 's been behaving .	Jeg tror ikke du ville være enig i måten Tom har oppført seg .
The day will surely come when your dream will come true .	Det kommer vel en gang en dag hvor drømmen din blir oppfylt .
Are you still looking for something to do ?	Leter du fortsatt etter noe å gjøre ?
Tom said it would be OK to do this .	Tom sa at det er okay å gjøre dette .
I want to make sure there is enough .	Jeg vil passe på at det er nok .
I do n't want to discourage you from trying to do that .	Jeg vil ikke avskrekke deg fra å prøve å gjøre det .
I do n't like you and I never will .	Jeg liker deg ikke og kommer heller aldri til å like deg .
No sooner had I left the house than it started to rain .	Så fort jeg hadde forlatt huset begynte det å regne .
Globally , around 26 million tons of plastic ends up in the ocean every year .	Globalt er det circa 26 millioner tonn plast som ender opp i havet hvert år .
You and I make about the same amount of money .	Du og jeg tjener omtrent likt .
Tom wore a new coat to school today .	Tom hadde på seg en ny frakk på skolen i dag .
I called and asked Tom if he knew when Mary would be arriving .	Jeg ringte og spurte Tom om han visste når Mary skulle ankomme .
Tom pushed the door open and stepped into the room .	Tom skøv døren åpen og gikk in i rommet .
Tom took a shortcut through a dark alley .	Tom tok en snarvei gjennom en mørk bakgate .
Be sure to check in at least 45 minutes prior to departure time .	Pass på å sjekke inn senest 45 minutter før avgang .
Tom has n't yet told us what he wants us to buy .	Tom har ikke fortalt oss hva han vil at vi skal kjøpe enda .
I have no words to express my gratitude .	Jeg har ikke ord på hvor takknemlig jeg er .
We are not alone in supporting the plan .	Vi er ikke alene om å støtte planen .
I thought maybe you could tell me what I need to know .	Jeg tenkte du kanskje kunne fortelle meg det jeg trenger å vite .
I do n't know who Tom is married to .	Jeg vet ikke hvem Tom er gift med .
I can n't help you right now. I 'm busy .	Jeg kan ikke hjelpe deg akkurat nå. Jeg er opptatt .
An apple will float in water , a pear will n't .	Et eple flyter i vann , en pære gjør ikke det .
Tom arrived at the gate and rang the bell .	Tom ankom ved porten og ringte på .
Tom put his toys back in the box .	Tom la lekene sine tilbake i eska .
I wish I had a house of my own .	Jeg skulle ønske jeg hadde et hus for meg selv .
Tom never said that he wanted to go .	Tom sa aldri at han hadde lyst til å gå .
We all have a right to be happy .	Vi har alle rett til å være lykkelig .
Tom said that he knew why Mary could n't do that .	Tom sa at han visste hvorfor Mary ikke kunne gjøre det .
Do you want to play soccer with us ?	Vil du spille fotball med oss ?
I asked him why he is so sad .	Jeg spurte ham om hvorfor han er så trist .
People often say that Japanese is a difficult language .	Folk sier ofte at japansk er et vanskelig språk .
I can n't speak French as well as Tom .	Jeg snakker ikke fransk like bra som Tom .
I 'm pretty sure Tom was trying to kill us .	Jeg er ganske sikker på at Tom prøvde å drepe oss .
I wish I could figure out how to make more money .	Jeg skulle ønske jeg kunne finne ut hvordan man tjener mer penger .
I never expected Tom to get out of prison .	Jeg forventet aldri at Tom skulle slippe ut av fengsel .
The prince fell in love with a woodcutter 's daughter .	Prinsen forelsket seg i en tømmerhugger sin datter .
I need to find out exactly what went wrong .	Jeg må finne ut nøyaktig hva som gikk galt .
I wish that noise would stop. It gets on my nerves .	Jeg skulle ønske at den lyden endelig ville holde opp , den går meg på nervene .
There is a red rose in the vase .	Det er en rød rose i vasen .
My teacher told me to turn in my paper as soon as possible .	Læreren min ba meg levere inn oppgaven min så fort som mulig .
I want to do something with my life .	Jeg vil gjøre noe med livet mitt .
I did n't know that you played the guitar .	Jeg visste ikke at du spilte gitar .
Why are you crying? It 's just a movie !	Hvorfor gråter du? Det er bare en film !
Most Swiss people can speak three or four languages .	De fleste sveitsere kan snakke tre eller fire språk .
Everything had to be rebuilt after the end of the war .	Alt måtte bli gjenoppbygd etter at krigen tok slutt .
Do you want us to take you home ?	Vil du at vi skal kjøre deg hjem ?
I think you know why I 'm calling you .	Jeg tror du vet hvorfor jeg ringer deg .
I have n't heard from her for a long time .	Jeg hadde ikke hørt fra henne på lenge .
Douglas Engelbart , the inventor of the computer mouse , was born on this day in 1925 .	Douglas Engelbart , oppfinneren av datamusen , var født på denne dagen i 1925 .
I do n't want to do this with you .	Jeg vil ikke gjøre dette sammen med deg .
Tom did n't know the reason why Mary would n't accept his invitation .	Tom visste ikke grunnen til at Mary ikke godtok invitasjonen hans .
I wish I could 've stuck around for a few more hours .	Jeg skulle ønske jeg kunne bli noen timer til .
"What 's going on in the cave? I 'm curious." "I have no idea."	"Hva foregår i hulen? Jeg er nysgjerrig." "Jeg aner ikke."
There are around three thousand mosques in Istanbul .	Det er rundt tre tusen moskéer i Istanbul .
I do n't want to hear any more of your stupid jokes .	Jeg har ikke lyst til å høre flere av de dumme vitsene dine .
Tom has n't yet told us what he wants to do .	Tom har ikke fortalt oss hva han vil gjøre enda .
"Have you seen my cell phone?" "It 's on the table."	"Har du sett mobiltelefonen min?" "Den ligger på bordet."
Tom was holding a small box in his hands .	Tom holdt en liten boks i hendene sine .
Can somebody tell me why Tom is angry ?	Kan noen fortelle meg hvorfor Tom er sint ?
Small children are afraid of being left alone in the dark .	Små barn er redde for å bli forlatt i mørket .
Tom was the only other person in the room .	Tom var den eneste andre personen i rommet .
They just want to make money. They do n't care about anything else .	De vil kun tjene penger. De bryr seg ikke om noe annet .
I wish I could figure out how to get more people to visit my website .	Jeg skulle ønske jeg kunne finne ut hvordan jeg kunne få mer folk til å besøke hjemmesiden min .
I have something that I want to say to you .	Det er noe jeg vil si deg .
Tom worked all day and was completely worn out .	Tom jobbet hele dagen og var helt utslitt .
I wish you had told me the truth .	Jeg skulle ønske du hadde fortalt meg sannheten .
